NO ./img/NON.xpm
SO ./img/SON.xpm
WE ./img/WEN.xpm
EA ./img/EAN.xpm

F 220,100,0
C 225,30,0

   1
  10111111
  10111111
  10111111
  10011111
 10E00001
 11111111