NO ./img/NON.xpm
SO ./img/SON.xpm
WE ./img/WEN.xpm
EA ./img/EAN.xpm

F 0,0,100
C 0,0,0

1111111111111111111111111111
11111100000000000000000000001
111111111100001110000000W0001
10000001100000000000010000001
11111111111111111111111111111
11111111111111111111111111111
