NO ./img/NON.xpm
SO ./img/SON.xpm
WE ./img/WEN.xpm
EA ./img/EAN.xpm

F 255,0,255
C 0,90,155

1111111111
1000001101
1110000001
1111110111
1110000001
1110000001
1110000001
111000E001
1110000001
1111111111
